8 9
4 5

1 2 3 3 3 2 1 1
1 3 0 0 0 2 2 1
2 2 5 3 4 0 2 2
3 0 4 0 0 0 0 3
3 5 0 5 3 4 0 3
2 3 2 0 0 0 2 2
1 1 3 0 3 0 3 1
1 1 3 0 0 0 3 1
1 1 2 3 3 3 2 1