9 8
7 4

1 2 3 3 3 2 1 1 1
2 2 0 0 0 2 3 2 1
3 0 5 0 5 0 5 3 1
3 0 3 0 3 3 0 2 2
3 0 0 0 0 4 4 0 3
2 3 2 0 3 0 4 0 3
1 1 3 0 0 0 2 3 2
1 1 2 3 3 3 2 1 1