6 7
3 2

2 3 3 3 3 2
3 0 0 0 0 3
3 0 3 0 0 3
3 0 4 6 0 3
3 0 5 6 0 3
3 0 0 0 0 3
2 3 3 3 3 2