8 7
4 3

1 2 3 3 3 3 3 2
1 3 0 0 0 0 0 3
1 3 0 5 4 5 0 3
2 2 0 4 0 4 0 3
3 0 0 5 4 5 0 3
3 0 0 0 0 0 0 3
2 3 3 3 3 3 3 2