11 11
4 4

1 1 1 2 3 2 1 1 1 1 1
1 1 2 2 0 3 1 2 3 3 2
1 2 2 0 0 2 3 2 0 0 3
2 2 0 4 0 0 0 0 0 0 3
3 0 0 0 0 4 0 3 0 0 3
2 3 2 0 4 2 3 2 0 0 3
1 1 3 0 0 3 5 5 0 0 3
1 2 2 0 3 2 5 3 0 3 2
1 3 0 0 0 0 0 0 2 2 1
1 3 0 0 0 0 0 2 2 1 1
1 2 3 3 3 3 3 2 1 1 1