9 9
2 4

1 1 1 1 2 3 3 2 1
1 2 3 3 2 0 0 3 1
2 2 0 4 0 0 0 3 1
3 0 0 3 0 3 4 3 1
3 5 0 5 5 0 0 2 2
2 2 0 3 0 3 0 0 3
1 3 0 0 0 4 0 0 3
1 3 0 0 2 3 3 3 2
1 2 3 3 2 1 1 1 1