12 6
10 2

2 3 3 3 3 2 1 2 3 3 3 2
3 0 0 0 0 2 3 2 0 0 0 3
3 0 4 4 0 0 0 0 0 3 0 3
3 0 4 0 3 5 5 5 0 0 0 3
3 0 0 0 2 3 3 3 3 3 3 2
2 3 3 3 2 1 1 1 1 1 1 1