7 8
3 6

2 3 3 3 3 3 2
3 0 0 0 0 0 3
3 0 5 4 5 0 3
3 0 4 5 4 0 3
3 0 5 4 5 0 3
3 0 4 5 4 0 3
3 0 0 0 0 0 3
2 3 3 3 3 3 2