6 7
2 3

2 3 3 2 1 1
3 0 5 3 1 1
3 0 0 2 3 2
3 6 0 0 0 3
3 0 0 4 0 3
3 0 0 2 3 2
2 3 3 2 1 1