9 9
4 4

1 2 3 3 3 3 3 3 2
2 2 0 0 0 0 0 0 3
3 0 0 0 5 0 0 0 3
3 0 0 0 4 0 0 0 3
3 0 5 4 0 4 5 0 3
2 3 3 2 4 0 0 0 3
1 1 1 3 5 0 0 0 3
1 1 1 3 0 0 0 2 2
1 1 1 2 3 3 3 2 1