6 7
1 2

2 3 3 3 2 1
3 5 0 0 2 2
3 0 4 4 0 3
2 2 0 0 0 3
1 2 2 0 0 3
1 1 2 2 5 3
1 1 1 2 3 2