8 8
2 6

1 1 2 3 3 3 2 1
2 3 2 0 0 0 3 1
3 0 4 0 3 0 2 2
3 0 3 0 0 5 0 3
3 0 5 0 0 3 0 3
2 2 4 3 5 4 0 3
1 3 0 0 0 2 3 2
1 2 3 3 3 2 1 1