8 6
6 2

2 3 3 3 3 3 3 2
3 0 0 0 0 0 0 3
3 0 5 6 6 4 0 3
3 0 0 0 0 0 0 3
2 3 3 3 2 0 0 3
1 1 1 1 2 3 3 2