11 8
2 4

1 1 1 1 1 1 2 3 3 3 2
1 1 1 1 1 1 3 5 0 0 3
1 1 1 1 1 1 3 5 3 0 3
2 3 3 3 3 3 2 5 3 0 3
3 0 0 0 4 0 4 0 4 0 3
3 0 3 0 3 0 3 0 2 3 2
3 0 0 0 0 0 0 0 3 1 1
2 3 3 3 3 3 3 3 2 1 1
