8 9
2 6

1 1 1 1 2 3 3 2
2 3 3 3 2 0 0 3
3 0 0 0 6 0 0 3
3 0 6 5 3 0 0 3
2 3 0 3 2 0 3 2
3 0 4 0 0 0 0 3
3 0 0 3 0 0 0 3
3 0 0 2 3 3 3 2
2 3 3 2 1 1 1 1