9 6
6 4

1 1 2 3 3 2 1 1 1
2 3 2 0 0 2 3 3 2
3 0 0 0 0 0 4 0 3
3 0 3 0 0 3 4 0 3
3 0 5 0 5 3 0 0 3
2 3 3 3 3 2 3 3 2