13 11
1 4

1 1 1 1 2 3 3 3 3 3 2 1 1
1 1 1 1 3 0 0 0 0 0 2 2 1
2 3 3 3 2 0 3 3 2 0 0 2 2
3 0 0 0 0 0 0 0 3 0 0 2 2
3 0 4 6 6 6 5 0 2 2 4 0 3
3 0 0 3 0 0 0 0 2 2 0 5 3
2 2 0 0 3 2 0 0 3 0 4 0 3
1 2 2 0 0 2 3 3 2 5 4 5 3
1 1 2 2 0 0 0 0 0 0 0 0 3
1 1 1 2 3 3 3 3 2 0 0 2 2
1 1 1 1 1 1 1 1 2 3 3 2 1